CHI = "countries/CHI.txt"
ROD = "countries/ROD.txt"
ROX = "countries/ROX.txt"
XZS = "countries/XZS.txt"
ROA = "countries/ROA.txt"
ROS = "countries/ROS.txt"
ROW = "countries/ROW.txt"
ROT = "countries/ROT.txt"
RJY = "countries/RJY.txt"
RYS = "countries/RYS.txt"
RHC = "countries/RHC.txt"
RDX = "countries/RDX.txt"
ROG = "countries/ROG.txt"
ROC = "countries/ROC.txt"
ROY = "countries/ROY.txt"
ROQ = "countries/ROQ.txt"
ROK = "countries/ROK.txt"
ROZ = "countries/ROZ.txt"
PRC = "countries/PRC.txt"
MEG = "countries/MEG.txt"
JAP = "countries/JAP.txt"
SOV = "countries/SOV.txt"
FRA = "countries/FRA.txt"
USA = "countries/USA.txt"
RAJ = "countries/RAJ.txt"
SIA = "countries/SIA.txt"
AFG = "countries/AFG.txt"
HOL = "countries/HOL.txt"
POR = "countries/POR.txt"
TAN = "countries/TAN.txt"
BHU = "countries/BHU.txt"
NEP = "countries/NEP.txt"
ROH = "countries/ROH.txt"
SYS = "countries/SYS.txt"
ROJ = "countries/ROJ.txt"
MCK = "countries/MCK.txt"
PCN = "countries/PCN.txt"
RFC = "countries/RFC.txt"
CAR = "countries/CAR.txt"
RON = "countries/RON.txt"
JDW = "countries/JDW.txt"
MGJ = "countries/MGJ.txt"
NAF= "countries/NAF.txt"
JDF= "countries/JDF.txt"
NHA= "countries/NHA.txt"
PRH= "countries/PRH.txt"
NSD= "countries/NSD.txt"
PRQ= "countries/PRQ.txt"
PRJ= "countries/PRJ.txt"
NSA= "countries/NSA.txt"
YGC= "countries/YGC.txt"
JZZ= "countries/JZZ.txt"
SOX= "countries/SOX.txt"
HZD= "countries/HZD.txt"
YHC= "countries/YHC.txt"
YUL= "countries/YUL.txt"
LDC= "countries/LDC.txt"
BTF= "countries/BTF.txt"
LZN= "countries/LZN.txt"